2222222222222222222222222222222222222222
2111111111111111111111111111111111111112
2111111111111111111131111111111111111112
2111111111111111111131111111111111111112
2111111111111111111131111111111111111112
2111111111111111111111111111111111111112
2111111111111111111111111111111111111112
2111111122222222111111111111111111111112
2111111111111112111111111111111111111112
2112222222222212111111111111111111111112
2111111111111112111111111111111111111112
2111111111111112111111111111111111111112
2111111111111111111111111111111111111112
2111111111111111111111111111111111111112
2111111111111111111111111111111111111112
2111111111111111111111111111111111111112
2111111111111111111111111111111111111112
2111121131111111111111111111111111111112
2111111111111111111111111111111111111112
2111111111111111111111111111111111111112
2111111111111111111111111111111111111112
2111111111111111111111111111111111111112
2111111111111111111111111111111111111112
2111111111111111111111111111111111111112
2111111111111111111111111111111111111112
2111111111111111111111111111111111111112
2111111111111111111111111111111111111112
2111111111111111111111111111111111111112
2111111111111111111111111111111111111112
2111111111111111111111111111111111111112
2111111111111111111111111111111111111112
2111111111111111111111111111111111111112
2111111111111111111111111111111111111112
2111111111111111111111111111111111111112
2111111111111111111111111111111111111112
2111111111111111111111111111111111111112
2111111111111111111111111111111111111112
2111111111111111111111111111111111111112
2111111111111111111111111111111111111112
2222222222222222222222222222222222222222
